#———————————————————————————————————————— localized English

        motd=$(curl -Ls msg.svija.com/$version/en.txt)

       keyup='U'
     keydown='D'
      keyyes='Y'
       keyno='N'

  whats_name='What is your first name?'
  name_error="Allowed characters:\n\n2-30 letters, dash, period and space. No accents."
          on='on'
    computer='your computer'
       wsite='site'
      server='website'
      folder='folder'
     replace='Synchronizing'
    finished='Synchronization complete'
        with='with'
        from='content of'
 downloading='Downloading from'
do_not_close='Do not close this window.'
     nothing='Nothing to upload.'
     user_id='user'
  first_name='name'

       uload="$red$keyup$none""pload"
       dload="$red$keydown$none""ownload"

      choose='Choose an option (return to cancel)'
upload_close=$red"Type x$none to close..."
    close_lc=$red"press return$none to close"

    canceled="$red""Synchronization canceled — $close_lc.$none\n"

     warning="$red""Replace $folder \"$sync_folder\" $on $computer$none — are you sure? [$keyyes/$keyno]:"
    warning2="has modified the site$none since your last upload. Continue? [$keyyes/$keyno]:"
   uploading="$replace $site $with \"$sync_folder\" $on $computer..."
 downloading="$downloading $folder \"$sync_folder\" $on $site...\n$do_not_close"
  bad_choice="Invalid choice — $close_lc."

