#———————————————————————————————————————— localized French

        motd=$(curl -Ls msg.svija.com/$version/fr.txt)

       keyup='U'
     keydown='D'
      keyyes='O'
       keyno='N'

  whats_name='Quel est votre prénom ?'
  name_error="Caractères possibles :\n\n2-30 lettres, le tiret, le point et l'espace. Pas d'accent."
          on='sur'
    computer='votre ordinateur'
       wsite='site'
      server='site web'
      folder='dossier'
     replace='Synchronisation de'
    finished='Synchronisation terminée'
        with='avec'
        from='contenus de'
 downloading='Téléchargement de'
do_not_close='Ne fermez pas la fenêtre.'
     nothing='Rien à télécharger.'
     user_id='utilisateur'
  first_name='prénom '

       uload="$red$keyup$none""ploader"
       dload="$red$keydown$none""ownloader"

      choose='Choisissez une option (retour pour annuler) '
    upload_close=$red"Appuyez sur la touche x$none pour fermer..."
    close_lc=$red"appuyer sur retour$none pour fermer"

    canceled="$red""Synchronisation annulée — $close_lc.$none\n"

     warning="$red""Remplacer $folder \"$sync_folder\" $on $computer$none — êtes-vous sûr ? [$keyyes/$keyno]:"
    warning2="a modifié le site$none depuis votre intervention. Continuer ? [$keyyes/$keyno]:"
   uploading="$replace $site $with \"$sync_folder\" $on $computer..."
 downloading="$downloading $folder \"$sync_folder\" $on $site...\n$do_not_close"
  bad_choice="Choix non-valide — $close_lc."

